B B B B B B B B B B B B B B B B B B B B
B B A B B B B M B B A M B B B A B M B B
B B B B B B B B B M B B B B B B B B B B
B B M B B M A A B B B B M A B B M B B B
B B B B B B B B A B A B B B B B B A B B
B B B B B M B B B B M B B B B M B B B B
A B M B B B B A B B B B A B B B B B B B
B B B B A B B B B A B B B B B A M B B B
B B B B B B M B B B B M B B B M B B B B
B B B M B B A B A B B B B B M B B B B B
A B B B B B B B B M B B B B B B B B B B
B B A B A B A M B B A B B M B A B M B B
B B B B B M M M M B B B B B B B M B B B
B B B A B B B B B B B M B B B B B B B B
M B B B B B A B B B B A B B B B M B B B
B B A B M B B B B B B B M B B A B B B B
B B M A B B A B M B B A B B B B B B B B
B B A M B B B B B B B B B B M B A B B B
B M B B A A B B B B M B B A B B B A B B
B B B B B B A M A B B B B B B B B B B B